000000000000
000000000000
001110000000
000000000000
000000000001
000011100000
111111110000
111111111111